###################
#.................#
#.#.###.#####.###.#
#...#.....#...#...#
###.#.###.#...#.###
#...#.#...#.......E
#.###.#.#####.###.#
#.#...#.......#...#
#.#.###########.###
#.#...............#
#.###########.#####
#.....#...........#
#.###.#.#########.#
#.#...#.#.........#
#.#####.#########.#
#.......#.........#
#.###############.#
#.................#
###################